{"structure":[
       "----------------------------------",
       "-                                -",
       "-                                -",
       "-                                -",
       "-                                -",
       "-                                -",
       "-                                -",
       "-                                -",
       "-                                -",
       "-                                -",
       "-                                -",
       "-                                -",
       "-                                -",
       "-                                -",
       "-                             d  -",
       "-                            --  -",
       "-                   -            -",
       "-          s        -          - -",
       "-                                -",
       "-                                -",
       "-                                -",
       "-                                -",
       "-                                -",
       "-                                -",
       "-                                -",
       "-                                -",
       "-                                -",
       "-                                -",
       "-                                -",
       "-                                -",
       "-                                -",
       "-                                -",
       "-                                -",
       "-                             d  -",
       "-                            --  -",
       "-                   -            -",
       "-          s        -          - -",
       "---------------------   ----------",
       "---------------------xxx----------"]}
