{"structure":[
       "----------------------------------",
       "-                                -",
       "-                           d    -",
       "-                                -",
       "-                          ---   -",
       "-                                -",
       "-          f   --        -     ---",
       "-                     -          -",
       "-                -               -",
       "-      -----------               -",
	   "-                                -",
	   "-                                -",
       "-                                -",
       "-    -                           -",
       "-    --                          -",
       "-                            --  -",
       "-                   -            -",
       "-           --      -          - -",
       "-                       -        -",
       "-                       f   -    -",
       "-                                -",
       "-                                -",
       "-                    --------    -",
       "-             -       -          -",
       "-                     -          -",
       "-       -         -              -",
       "-                                -",
       "-                                -",
       "- --                             -",
       "-                                -",
       "-      -     ---                 -",
       "-                   - --         -",
       "-                                -",
       "-                            --  -",
       "-           f                    -",
       "-    p              -            -",
       "-                   -          - -",
       "---------------------   ----------",
       "---------------------xxx----------"]}
