{"structure":[
       "----------------------------------",
       "-                                -",
       "-                           d    -",
       "-                                -",
       "-                          ---   -",
       "-                                -",
       "-              --        -     ---",
       "-                     -          -",
       "-             s  -               -",
       "-         --------               -",
	   "-                                -",
	   "-                                -",
       "-                                -",
       "-    -                           -",
       "-    --                          -",
       "-                            --  -",
       "-                   -            -",
       "-           --      -          - -",
       "-                       -        -",
       "-                           -    -",
       "-                                -",
       "-                        s       -",
       "-                     -------    -",
       "-             -       -          -",
       "-                     -          -",
       "-       -         -              -",
       "-                                -",
       "-                                -",
       "- --                             -",
       "-                                -",
       "-      -     ---                 -",
       "-                   - --         -",
       "-                                -",
       "-                            --  -",
       "-                                -",
       "-    p              -            -",
       "-               s   -          - -",
       "---------------------   ----------",
       "---------------------xxx----------"]}
