{"structure":[
       "--------------------------------------------------------------------",
       "-                                                                  -",
       "-                                                                  -",
       "-                                                                  -",
       "-                                                                  -",
       "-                                                                  -",
       "-                                                                  -",
       "-                                   f                              -",
       "-         -       --     -                                      d  -",
       "-                                                ----              -",
       "-       --                     ------------                 --------",
       "-                                                                  -",
       "-           -                                                      -",
       "-                 -                                                -",
       "-                      -----  -  -  -  -  -                        -",
       "-                                                ----              -",
       "-                                                          -----   -",
       "-                                                                  -",
       "-          --                                     f                -",
       "-                                                        -         -",
       "-                -                                                 -",
       "- p     -                          -----      ---------            -",
       "-       -                ----                                      -",
       "---------                                                          -",
       "---------xxxxxxxxxxxxxxxxxxxxxxxxxxxxxxxxxxxxxxxxxxxxxxxxxxxxxxxxxxx"]}
